20 0 20 0 20 0 20 0 10 0 20 0 10 0 30 0 10 0 30 30 10 30 30 0 10 0 30 0 10 0 30 0 10 0 20 0 10 0 20 0 20 0 20 0 20 0 
10 20 10 0 10 20 20 0 10 0 10 0 10 0 10 0 10 0 30 0 10 0 10 0 10 0 30 0 10 0 10 0 10 0 10 0 10 0 20 0 10 0 10 0 10 0 
10 0 10 0 10 0 20 0 10 0 20 0 10 0 30 0 10 0 30 0 10 0 30 0 10 0 30 0 10 0 30 0 10 0 20 0 10 0 20 0 10 0 10 11 10 0 
10 20 10 0 10 0 20 0 10 0 10 0 10 0 30 0 10 0 30 0 10 0 30 0 10 0 30 0 10 0 30 0 10 0 10 0 10 0 20 0 10 0 10 0 10 0 
20 0 20 0 10 0 20 0 10 0 20 0 10 0 30 0 10 0 30 0 10 0 30 0 10 0 30 0 10 0 30 0 10 0 20 0 10 0 20 0 10 0 20 0 20 0 
10 0 10 0 10 0 20 0 10 0 10 0 10 0 30 0 10 0 30 0 10 0 30 0 10 0 30 0 10 0 30 0 10 0 10 0 10 0 20 0 10 0 10 0 10 0 
10 0 20 0 20 0 20 0 10 0 20 0 10 0 30 0 10 0 30 0 10 0 30 0 10 0 30 0 10 0 30 0 10 0 20 0 10 0 20 0 20 0 20 0 10 0 
10 0 10 0 10 0 10 0 10 0 20 0 10 0 30 0 10 0 10 0 10 0 30 0 10 0 10 0 10 0 30 0 10 0 20 0 10 0 10 0 10 0 10 0 10 0 
10 0 10 0 10 0 10 0 10 0 20 0 10 0 30 0 10 0 10 0 10 0 30 0 10 0 10 0 10 0 30 0 10 0 20 0 10 0 10 0 10 0 10 0 10 0 
10 0 20 0 20 0 20 0 10 0 20 0 10 0 30 0 10 0 30 0 10 0 30 0 10 0 30 0 10 0 30 0 10 0 20 0 10 0 20 0 20 0 20 0 10 0 
10 0 10 0 10 0 20 0 10 0 10 0 10 0 30 0 10 0 30 0 10 0 30 0 10 0 30 0 10 0 30 0 10 0 10 0 10 0 20 0 10 0 10 0 10 0 
20 0 20 0 10 0 20 0 10 0 20 0 10 0 30 0 10 0 30 0 10 0 30 0 10 0 30 0 10 0 30 0 10 0 20 0 10 0 20 0 10 0 20 0 20 0 
10 0 10 0 10 0 20 0 10 0 10 0 10 0 30 0 10 0 30 0 10 0 30 0 10 0 30 0 10 0 30 0 10 0 10 0 10 0 20 0 10 0 10 0 10 21 
10 0 10 10 10 0 20 0 10 0 20 0 10 0 30 0 10 0 30 0 10 0 30 0 10 0 30 0 10 0 30 0 10 0 20 0 10 0 20 0 10 0 10 0 10 0 
10 0 10 0 10 0 20 0 10 0 10 0 10 0 10 0 10 0 30 0 10 0 10 0 10 0 30 0 10 0 10 0 10 0 10 0 10 0 20 0 10 21 10 0 10 21 
20 0 20 0 20 0 20 0 10 0 20 0 10 0 30 0 10 0 30 0 10 0 30 0 10 0 30 0 10 0 30 0 10 0 20 0 10 0 20 0 20 0 20 0 20 0 
