10 0 10 0 10 0 10 0 10 0 10 0 10 0 10 0 20 0 10 20 10 0 10 20 10 0 10 20 20 0 10 0 10 0 10 0 10 0 10 0 10 0 10 0 10 0 
10 0 10 0 10 0 10 0 10 0 10 0 10 0 10 0 20 0 10 0 10 0 10 0 10 0 10 0 20 0 10 0 10 0 10 0 10 0 10 0 10 0 10 0 10 0 
10 0 10 0 10 0 10 0 10 0 10 0 10 0 10 0 20 0 10 0 10 0 10 0 10 0 10 0 20 0 10 0 10 0 10 0 10 0 10 0 10 0 10 0 10 0 
10 0 10 0 10 0 10 0 10 0 10 0 10 0 10 0 20 0 20 0 10 0 20 0 10 0 20 0 20 0 10 0 10 0 10 0 10 0 10 0 10 0 10 0 10 0 
10 0 10 0 10 0 10 0 10 0 10 0 20 0 10 0 10 0 20 0 10 0 10 0 10 0 20 0 10 0 10 0 20 0 10 0 10 0 10 0 10 0 10 0 10 0 
10 0 10 0 10 0 10 0 10 0 10 0 20 0 20 0 10 0 10 0 10 0 20 0 10 0 10 0 10 0 20 0 20 0 10 0 10 0 10 0 10 0 10 0 10 0 
10 0 10 0 10 0 10 0 10 0 10 0 10 0 20 0 20 0 20 0 20 0 20 0 20 0 20 0 20 0 20 0 10 0 10 0 10 0 10 0 10 0 10 0 10 0 
10 0 10 0 10 0 10 0 10 0 10 0 10 0 10 0 10 0 10 0 10 0 10 0 10 0 10 0 10 0 10 0 10 0 10 0 10 0 10 0 10 0 10 0 10 0 
10 0 10 0 10 0 20 0 20 0 20 0 10 0 10 0 10 0 10 0 10 0 10 0 10 0 10 0 10 0 10 0 10 0 20 0 20 0 20 0 10 0 10 0 10 0 
10 0 10 0 10 0 10 0 10 0 20 0 10 0 10 0 10 0 10 0 10 0 10 0 10 0 10 0 10 0 10 0 10 0 20 0 10 0 10 0 10 0 10 0 10 0 
20 0 20 0 20 0 20 0 10 0 20 0 20 0 20 0 10 0 10 0 10 0 10 0 10 0 10 0 10 0 20 0 20 0 20 0 10 0 20 0 20 0 20 0 20 0 
10 0 10 0 10 0 10 0 10 0 10 0 10 0 20 0 10 0 10 0 10 0 10 0 10 0 10 0 10 0 20 0 10 0 10 0 10 0 10 0 10 0 10 0 10 0 
10 0 10 0 10 0 20 0 10 0 20 0 10 0 20 0 10 0 10 0 10 0 10 0 10 0 10 0 10 0 20 0 10 0 20 0 10 0 20 0 10 0 10 0 10 0 
10 21 10 0 10 0 10 0 10 0 20 0 10 0 10 0 10 0 10 0 10 0 10 0 10 0 10 0 10 0 10 0 10 0 20 0 10 0 10 0 10 0 10 0 10 22 
10 0 10 0 10 0 10 0 10 0 20 0 10 0 10 0 10 0 10 0 10 0 10 0 10 0 10 0 10 0 10 0 10 0 20 0 10 0 10 0 10 0 10 0 10 0 
10 21 10 0 10 21 10 0 10 0 20 0 10 0 10 0 10 0 10 0 10 0 10 0 10 0 10 0 10 0 10 0 10 0 20 0 10 0 10 0 10 22 10 0 10 22 
